R 1000 1000
NO ./brick.xpm
SO ./metal.xpm
WE ./stone.xpm
EA ./wood.xpm
S ./barel.xpm
F 42 ,100,0
C 225,150,0

  11111
1110001
1100201
1002001
1000001
1E00001
1111111
