R 200 200
NO ./brick.xpm
SO ./metal.xpm
WE ./stone.xpm
EA ./wood.xpm
S ./barel.xpm
F 40, 100,  40
C 25,140,241

11111111111111111111111111111   
1111000000000000000000001111  
10000000100000111111111101111  
100100000000111111110000000111
1011000001110000000000000001
1000000000110000011101111000111
1111011111111101110000001000111111111
1111011111111101110101001000111111
1100N00011010101110000001000000001
1000200001111000110000001000111111  
11111111111111111111111111111
