R 500 500
NO ./brick.xpm
SO ./metal.xpm
WE ./stone.xpm
EA ./wood.xpm
S ./barel.xpm
F 40, 100,  40
C 25,140,241

11111111111111111111111111111  
111110000011111000000000001111  
1000000010011  111111111101111  
1001000000011111000020000000111
10110000011100N0000020000000001
1000000000110000011101111000111
11110111111111011100000010001  
11110111111111011101010010001  
11000000110101011100000010001  
10002000000000001100000010001  
11111111111111111111111111111  
