R 500 500
NO ./texture/north.xpm
SO ./texture/south.xpm
WE ./texture/west.xpm
EA ./texture/east.xpm
S ./textures/barel.xpm
F 40, 100,  40
C 25,140,241

11111
10001
10201
10001
10N01
10001
11111

